study_type	backward
exp_len	10
wash_len	2
obs_len	8
obs_end_date	2019/01/01
exp_f1998	FALSE
ancs	EUR
obs_age_range	32,70
score_type	CCI, EDU, ZIP, PheRS, BMI
covs	SEX, YEAR_OF_BIRTH
min_indvs	50
write_res	TRUE
res_dir	path/to/save/results/
pheno_file_path	path/to/phenotyp_file.tsv
icd_file_path	path/to/icd_file.tsv
prs_dir_path	path/to/prs/directory/
prs_file_end .sscore
prs_id_col_name	#IID
prs_score_col_name	Score
phers_dir_path	path/to/phers/directory/
create_score_combos	TRUE
